111111111111111111111111111111111111111
1000P0000CC00000C0C0C0C0C0C0C0C0C0C0CE1
1000000000001000000000000C0CCCC0C0C0C11
1000000000110100000000000C0CCCC0C0C0C01
1000000000001000000000000C0CCCC0C0C0C01
1000000000000000000000000C0CCCC0C0C0C01
1000000000000000000000000C0CCCC0C0C0C01
1000000000000000000000000C0CCCC0C0C0C01
1000000000000000000000000C0CCCC0C0C0C01
1000000000000000000000000C0CCCC0C0C0C01
1000000000000000000000000C0CCCC0C0C0C01
111111111111111111111111111111111111111