111111111111111111111111111111111111111
10000000CC00000C0C0C0C0C0C0C0C0C0C0C011
1000000000001000000000000C0CCCC0C0C0C11
1000000000111111111110000C0CCCC0C0C0C01
1000000000001000000000000C0CCCC0C0C0C01
1000000000001000000000000C0CCCC0C0C0C01
1000000000000011111110000C0CCCC0C0C0C01
1000000000001000000000000C0CCCC0C0C0C01
1000000000001000000000000C0CCCC0C0C0C01
1000000000001000000000000C0CCCC0C0C0C01
100000000000100000P0E0000C0CCCC0C0C0C01
111111111111111111111111111111111111111